0,0,0,0,0,0,0,0,0,0,0,0,0,0,0
0,0,0,2,0,0,0,0,0,0,0,0,0,0,0
0,0,0,0,0,0,0,0,0,0,0,0,0,0,0
0,0,0,k,0,0,0,0,r,0,0,c,0,0,0
0,0,0,0,0,0,0,0,0,0,h,c,0,0,0
0,0,0,0,0,0,0,c,0,0,0,0,0,0,0
0,0,0,0,0,0,0,0,0,0,0,0,0,0,0
0,0,0,0,0,0,0,0,0,0,0,0,0,0,0
0,0,0,0,0,0,0,0,t,0,0,0,0,0,0
0,0,0,0,0,0,0,0,0,0,0,0,0,0,0
0,0,0,0,0,0,0,5,0,0,0,n,0,0,0
0,0,0,0,0,0,0,0,0,0,0,0,0,0,0
